Afghanistan	Kabul
Albania	Tirana
Algeria	Algiers
Andorra	Andorra la Vella
Angola	Luanda
Antigua and Barbuda	St. John's
Argentina	Buenos Aires
Armenia	Yerevan
Australia	Canberra	Sydney	Melbourne
Austria	Vienna
Azerbaijan	Baku
Bahamas	Nassau
Bahrain	Manama
Bangladesh	Dhaka
Barbados	Bridgetown
Belarus	Minsk
Belgium	Brussels
Belize	Belmopan
Benin	Porto Novo	Cotonou
Bhutan	Thimphu
Bolivia	Sucre	La Paz
Bosnia Herzegovina	Sarajevo
Botswana	Gaborone
Brazil	Brasília	Sao Paulo	Rio de Janeiro
Brunei	Bandar Seri Begawan
Bulgaria	Sofia
Burkina Faso	Ouagadougou
Burma	Naypyidaw
Burundi	Bujumbura
Cambodia	Phnom Penh
Cameroon	Yaoundé	Douala
Canada	Ottawa	Toronto	Montreal	Vancouver
Cape Verde	Praia
Central African Republic	Bangui
Chad	N'Djamena
Chile	Santiago	Valparaíso	Santiago
China	Beijing	Shanghai
Colombia	Bogotá
Comoros	Moroni
Democratic Republic of the Congo	Kinshasa	Congo
Republic of the Congo	Brazzaville
Costa Rica	San Jose
Croatia	Zagreb
Cuba	Havana
Cyprus	Nicosia
Czech Republic	Prague
Denmark	Copenhagen
Djibouti	Djibouti
Dominica	Roseau
Dominican Republic	Santo Domingo
East Timor	Dili
Ecuador	Quito	Guayaquil
Egypt	Cairo
El Salvador	San Salvador
Equatorial Guinea	Malabo
Eritrea	Asmara
Estonia	Tallinn
Ethiopia	Addis Ababa
Fiji	Suva
Finland	Helsinki
France	Paris
Gabon	Libreville
Gambia	Banjul	Serekunda
Georgia	Tbilisi
Germany	Berlin
Ghana	Accra
Greece	Athens
Grenada	St. George's
Guatemala	Guatemala City
Guinea	Conakry
Guinea Bissau	Bissau
Guyana	Georgetown
Haiti	Port au Prince
Honduras	Tegucigalpa
Hungary	Budapest
Iceland	Reykjavík
India	New Delhi	Mumbai	Bombay	Delhi	Bangalore	Hyderabad	Ahmedabad	Chennai	Kolkata
Indonesia	Jakarta
Iran	Kerman	Tehran
Iraq	Baghdad
Ireland	Dublin
Israel	Jerusalem	Tel Aviv
Italy	Rome	Milan	Naples
Ivory Coast	Yamoussoukro	Abidjan
Jamaica	Kingston
Japan	Tokyo
Jordan	Amman
Kazakhstan	Astana	Almaty	Shymkent
Kenya	Nairobi
Kiribati	South Tarawa
North Korea	Pyongyang
South Korea	Seoul
Kuwait	Kuwait City
Kyrgyzstan	Bishkek
Laos	Vientiane
Latvia	Riga
Lebanon	Beirut
Lesotho	Maseru
Liberia	Monrovia
Libya	Tripoli
Liechtenstein	Vaduz	Schaan
Lithuania	Vilnius
Luxembourg	Luxembourg City
Macedonia	Skopje
Madagascar	Antananarivo
Malawi	Lilongwe
Malaysia	Kuala Lumpur	Putrajaya
Maldives	Malé
Mali	Bamako
Malta	Valletta
Marshall Islands	Majuro
Mauritania	Nouakchott
Mauritius	Port Louis
Mexico	Mexico City
Micronesia	Palikir	Weno
Moldova	Chișinău
Monaco	Monaco
Mongolia	Ulan Bator
Montenegro	Podgorica
Morocco	Rabat	Casablanca
Mozambique	Maputo
Namibia	Windhoek
Nauru	Yaren District
Nepal	Kathmandu
Netherlands	Amsterdam	The Hague	Rotterdam
New Zealand	Wellington	Auckland	Christchurch
Nicaragua	Managua
Niger	Niamey
Nigeria	Abuja	Lagos
Norway	Oslo
Oman	Muscat
Pakistan	Islamabad	Karachi	Lahore
Palau	Ngerulmud
Palestine	Jerusalem	Gaza City	Ramallah	West Bank
Panama	Panama City
Papua New Guinea	Port Moresby
Paraguay	Asunción
Peru	Lima
Philippines	Manila	Quezon City
Poland	Warsaw
Portugal	Lisbon
Qatar	Doha
Romania	Bucharest
Russia	Moscow
Rwanda	Kigali
Saint Kitts and Nevis	Basseterre
Saint Lucia	Castries
Saint Vincent and the Grenadines	Kingstown
Samoa	Apia
San Marino	San Marino	Serravalle	Borgo Maggiore
São Tomé and Príncipe	São Tomé
Saudi Arabia	Riyadh
Scotland	Edinburgh	Glasgow
Senegal	Dakar
Serbia	Belgrade
Seychelles	Victoria
Sierra Leone	Freetown
Singapore	Singapore
Slovakia	Bratislava
Slovenia	Ljubljana
Solomon Islands	Honiara
Somalia	Mogadishu
South Africa	Pretoria	Cape Town	Bloemfontein	Johannesburg 
South Sudan	Juba
Spain	Madrid
Sri Lanka	Sri Jayawardenepura Kotte	Kotte	Colombo
Sudan	Khartoum	Omdurman
Suriname	Paramaribo
Swaziland	Mbabane	Lobamba	Manzini
Sweden	Stockholm
Switzerland	Bern	Zurich	Geneva	Basel	Lausanne
Syria	Damascus	Aleppo
Tajikistan	Dushanbe
Tanzania	Dodoma	Dar es Salaam	Dar es Salaam	Mwanza
Thailand	Bangkok
Taiwan	Taipei
Togo	Lomé
Tonga	Nuku alofa
Trinidad and Tobago	Chaguanas	San Fernando	San Juan
Tunisia	Tunis
Turkey	Ankara	Istanbul
Turkmenistan	Ashgabat
Tuvalu	Funafuti
Uganda	Kampala
Ukraine	Kiev
United Arab Emirates	Abu Dhabi	Dubai	Sharjah
United Kingdom	London
United States	White House	Washington D.C.	New York City	Los Angeles	Chicago	Houston	Philadelphia	Phoenix	San Antonio	San Diego	Dallas	Austin	Indianapolis	San Francisco	Charlotte	Detroit	Memphis	Boston	Seattle	Denver	Baltimore
Uruguay	Montevideo
Uzbekistan	Tashkent
Vanuatu	Port Vila
Vatican City	Vatican City
Venezuela	Caracas
Vietnam	Hanoi	Ho Chi Minh City
Wales	Cardiff
Yemen	Sana'a
Zaire	Kinshasa
Zambia	Lusaka
Zimbabwe	Harare