Afghanistan	Hamid Karzai	Ashraf Ghani
Albania	Bujar Nishani	Edi Rama
Algeria	Abdelaziz Bouteflika	Abdelmalek Sellal
Andorra	Joan Enric Vives Sicília	Josep Maria Mauri	François Hollande	Sylvie Hubac	Antoni Martí
Angola	José Eduardo dos Santos
Antigua and Barbuda	Louise Lake-Tack	Gaston Browne
Argentina	Cristina Fernández de Kirchner
Armenia	Serzh Sargsyan	Hovik Abrahamyan
Australia	Peter Cosgrove	Tony Abbott
Austria	Heinz Fischer	Werner Faymann
Azerbaijan	Ilham Aliyev	Artur Rasizade
Bahamas	Marguerite Pindling	Perry Christie
Bahrain	Sheikh Hamad bin Isa	Khalifa bin Salman
Bangladesh	Abdul Hamid	Sheikh Hasina
Barbados	Elliott Belgrave	Freundel Stuart
Belarus	Alexander Lukashenko	Mikhail Myasnikovich
Belgium	Philippe	Elio Di Rupo
Belize	Colville Young	Dean Barrow
Benin	Yayi Boni
Bhutan	Jigme Khesar Namgyel Wangchuck	Tshering Tobgay
Bolivia	Evo Morales
Bosnia Herzegovina	Valentin Inzko	Bakir Izetbegović	Željko Komšić	Nebojša Radmanović	Vjekoslav Bevanda
Botswana	Ian Khama
Brazil	Dilma Rousseff
Brunei	Hassanal Bolkiah
Bulgaria	Rosen Plevneliev	Plamen Oresharski
Burkina Faso	Blaise Compaoré	Luc Adolphe Tiao
Burma	Thein Sein
Burundi	Pierre Nkurunziza
Cambodia	Norodom Sihamoni	Hun Sen
Cameroon	Paul Biya	Philémon Yang
Canada	David Johnston	Stephen Harper
Cape Verde	Jorge Carlos Fonseca	José Maria Neves
Central African Republic	Catherine Samba Panza	André Nzapayeké
Chad	Idriss Déby	Kalzeubet Pahimi Deubet
Chile	Michelle Bachelet
China	Xi Jinping	Li Keqiang
Colombia	Juan Manuel Santos
Comoros	Ikililou Dhoinine
Democratic Republic of the Congo	Joseph Kabila	Augustin Matata Ponyo
Republic of the Congo	Denis Sassou Nguesso
Costa Rica	Luis Guillermo Solís
Croatia	Ivo Josipović	Zoran Milanović
Cuba	Raúl Castro
Cyprus	Nicos Anastasiades
Czech Republic	Miloš Zeman	Bohuslav Sobotka
Denmark	Queen Margrethe II	Helle Thorning-Schmidt
Djibouti	Ismaïl Omar Guelleh	Abdoulkader Kamil Mohamed
Dominica	Charles Savarin	Roosevelt Skerrit
Dominican Republic	Danilo Medina
East Timor	Taur Matan Ruak	Xanana Gusmão
Ecuador	Rafael Correa
Egypt	Abdel Fattah el-Sisi	Ibrahim Mahlab
El Salvador	Salvador Sánchez Cerén
Equatorial Guinea	Teodoro Obiang Nguema Mbasogo	Vicente Ehate Tomi
Eritrea	Isaias Afewerki
Estonia	Toomas Hendrik Ilves	Taavi Rõivas
Ethiopia	Mulatu Teshome	Hailemariam Desalegn
Fiji	Ratu Epeli Nailatikau	Frank Bainimarama
Finland	Sauli Niinistö	Alexander Stubb
France	François Hollande	Manuel Valls
Gabon	Ali Bongo Ondimba	Daniel Ona Ondo
Gambia	Yahya Jammeh
Georgia	Giorgi Margvelashvili	Irakli Garibashvili
Germany	Joachim Gauck	ngela Merkel
Ghana	John Dramani Mahama
Greece	Karolos Papoulias	Antonis Samaras
Grenada	Cécile La Grenade	Keith Mitchell
Guatemala	Otto Pérez Molina
Guinea	Alpha Condé	Mohamed Said Fofana
Guinea Bissau	José Mário Vaz	Domingos Simoes Pereira
Guyana	Donald Ramotar	Sam Hinds
Haiti	Michel Martelly	Laurent Lamothe
Honduras	Juan Orlando Hernández
Hungary	János Áder	Viktor Orbán
Iceland	Ólafur Ragnar Grímsson	Sigmundur David Gunnlaugsson
India	Pranab Mukherjee	Narendra Modi
Indonesia	Susilo Bambang Yudhoyono	Joko Widodo
Iran	Khamenei	Rouhani	Zarif
Iraq	Jalal Talabani	Nouri al Maliki
Ireland	Michael Higgins	Taoiseach	Enda Kenny
Israel	Shimon Peres	Reuven Rivlin	Benjamin Netanyahu
Italy	Giorgio Napolitano	Matteo Renzi
Ivory Coast	Alassane Ouattara	Daniel Kablan Duncan
Jamaica	Patrick Allen	Portia Simpson-Miller
Japan	Akihito	Shinzo Abe
Jordan	Abdullah II	Abdullah Ensour
Kazakhstan	Nursultan Nazarbayev	Karim Masimov
Kenya	Uhuru Kenyatta
Kiribati	Anote Tong
Kuwait	Sheikh Sabah Al-Ahmad	Sheikh Jaber Al-Mubarak
Kyrgyzstan	Almazbek Atambayev	Djoomart Otorbaev
Laos	Choummaly Sayasone	Thongsing Thammavong
Latvia	Andris Bērziņš	Laimdota Straujuma
Lebanon	Tammam Salam
Lesotho	Letsie III	Tom Thabane
Liberia	Ellen Johnson Sirleaf
Libya	Nouri Abusahmain	Abdullah al-Thani
Liechtenstein	Hans-Adam II	Prince Alois	Adrian Hasler
Lithuania	Dalia Grybauskaitė	Algirdas Butkevičius
Luxembourg	Henri	Xavier Bettel
Macedonia	Gjorge Ivanov	Nikola Gruevski
Madagascar	Hery Rajaonarimampianina	Roger Kolo
Malawi	Peter Mutharika
Malaysia	Yang di-Pertuan Agong	Abdul Halim	Najib Razak
Maldives	Abdulla Yameen
Mali	Ibrahim Boubacar Keita	Moussa Mara
Malta	Marie Louise Coleiro Preca	Joseph Muscat
Marshall Islands	Christopher Loeak
Mauritania	Mohamed Ould Abdel Aziz	Moulaye Ould Mohamed Laghdaf
Mauritius	Rajkeswur Purryag	Navin Ramgoolam
Mexico	Enrique Peña Nieto
Micronesia	Manny Mori
Moldova	Nicolae Timofti	Iurie Leancă
Monaco	Prince Albert II	Michel Roger
Mongolia	Tsakhiagiin Elbegdorj	Norovyn Altankhuyag
Montenegro	Filip Vujanović	Milo Đukanović
Morocco	Mohammed VI	Abdelilah Benkirane
Mozambique	Armando Guebuza	Alberto Vaquina
Namibia	Hifikepunye Pohamba	Hage Geingob
Nauru	Baron Waqa
Nepal	Ram Baran Yadav	Sushil Koirala
Netherlands	Willem-Alexander	Mike Eman	Ivar Asjes	Mark Rutte	Sarah Wescot-Williams
New Zealand	Jerry Mateparae	John Key
Nicaragua	Daniel Ortega
Niger	Mahamadou Issoufou	Brigi Rafini
Nigeria	Goodluck Jonathan
North Korea	Kim Jong-un	Kim Yong-nam	Pak Pong-ju
Norway	king Harald V	Erna Solberg
Oman	Qaboos bin Said
Pakistan	Mamnoon Hussain	Nawaz Sharif
Palau	Tommy Remengesau
Palestine	Mahmoud Abbas	Rami Hamdallah
Panama	Juan Carlos Varela
Papua New Guinea	Michael Ogio	Peter O'Neill
Paraguay	Horacio Cartes
Peru	Ollanta Humala	René Cornejo
Philippines	Benigno Aquino III
Poland	Bronisław Komorowski	Donald Tusk
Portugal	Aníbal Cavaco Silva	Pedro Passos Coelho
Qatar	Sheikh Tamim bin Hamad 	Sheikh Abdullah bin Nasser
Romania	Traian Băsescu	Victor Ponta
Russia	Vladimir Putin	Dmitry Medvedev
Rwanda	Paul Kagame	Pierre Habumuremyi
Saint Kitts and Nevis	Edmund Lawrence	Denzil Douglas
Saint Lucia	Pearlette Louisy	Kenny Anthony
Saint Vincent and the Grenadines	Frederick Ballantyne	Ralph Gonsalves
Samoa	O le Ao o le Malo	Tufuga Efi	Tuilaepa Aiono Sailele Malielegaoi
San Marino	Valeria Ciavatta	Luca Beccari
São Tomé and Príncipe	Manuel Pinto da Costa	Gabriel Costa
Saudi Arabia	King Abdullah
Senegal	Macky Sall	Mohamed Dionne
Serbia	Tomislav Nikolić	Aleksandar Vučić
Seychelles	James Michel
Sierra Leone	Ernest Bai Koroma
Singapore	Tony Tan	Lee Hsien Loong
Slovakia	Andrej Kiska	Robert Fico
Slovenia	Borut Pahor	Alenka Bratušek	Prime Minister-designate - Miro Cerar
Solomon Islands	Frank Kabui	Gordon Darcy Lilo
Somalia	Hassan Sheikh Mohamud	Abdiweli Sheikh Ahmed
South Africa	Jacob Zuma
South Korea	Park Geun-hye	Jung Hong-won
South Sudan	Salva Kiir Mayardit
Spain	King Felipe VI	Mariano Rajoy
Sri Lanka	Mahinda Rajapaksa	D. M. Jayaratne
Sudan	Omar al-Bashir
Suriname	Dési Bouterse
Swaziland	Mswati III	Barnabas Sibusiso Dlamini
Sweden	Carl XVI Gustaf	Fredrik Reinfeldt
Switzerland	Doris Leuthard	Eveline Widmer-Schlumpf	Ueli Maurer	Didier Burkhalter	Simonetta Sommaruga	Johann Schneider-Ammann	Alain Berset
Syria	Bashar al-Assad	Wael Nader Al-Halqi
Tajikistan	Emomalii Rahmon	Kokhir Rasulzoda
Tanzania	Jakaya Kikwete	Mizengo Pinda
Thailand	Bhumibol Adulyadej	Prayuth Chan-ocha
Togo	Faure Gnassingbé	Kwesi Ahoomey-Zunu
Tonga	Tupou VI	Sialeʻataongo Tuʻivakanō
Trinidad and Tobago	Anthony Carmona	Kamla Persad-Bissessar
Tunisia	Moncef Marzouki	Mehdi Jomaa
Turkey	Abdullah Gul	Recep Tayyip Erdoğan
Turkmenistan	Gurbanguly Berdimuhamedow
Tuvalu	Iakoba Italeli	Enele Sopoaga
Uganda	Yoweri Museveni	Amama Mbabazi
Ukraine	Petro Poroshenko	Arseniy Yatsenyuk
United Arab Emirates	Sheikh Khalifa bin Zayed	Sheikh Mohammed bin Rashid
United Kingdom	Queen Elizabeth	David Cameron
United States	Barack Obama	Obama	John Kerry
Uruguay	José Mujica
Uzbekistan	Islam Karimov	Shavkat Mirziyoyev
Vanuatu	Iolu Abil	Joe Natuman
Vatican City	Pope Francis	Giuseppe Bertello
Venezuela	Nicolás Maduro
Vietnam	Trương Tấn Sang	Nguyễn Tấn Dũng
Yemen	Rabbuh Mansur Hadi	Mohammed Basindawa
Zambia	Michael Sata
Zimbabwe	Robert Mugabe